//MAP CONVERTED BY dmm2tgm.py THIS HEADER COMMENT PREVENTS RECONVERSION, DO NOT REMOVE
"a" = (
/obj/machinery/power/shuttle_engine/heater{
	dir = 8
	},
/obj/structure/window/reinforced/plasma/spawner/directional/west,
/obj/structure/window/reinforced/plasma/spawner/directional/east,
/turf/open/floor/iron/shuttle/cargo,
/area/space)
"b" = (
/obj/structure/table/reinforced/titaniumglass,
/obj/machinery/microwave/frontier_printed,
/turf/open/floor/iron/shuttle/cargo,
/area/space)
"c" = (
/obj/structure/window/reinforced/spawner/directional/west,
/obj/machinery/atmospherics/components/unary/vent_pump/on/layer4{
	dir = 1
	},
/obj/structure/closet/firecloset/wall{
	pixel_y = -29
	},
/turf/open/floor/iron/shuttle/cargo,
/area/space)
"d" = (
/turf/open/floor/iron/shuttle/cargo,
/area/space)
"e" = (
/obj/structure/cable,
/obj/machinery/portable_atmospherics/canister/air,
/obj/machinery/atmospherics/components/unary/portables_connector/visible/layer4{
	dir = 4
	},
/turf/open/floor/iron/shuttle/cargo,
/area/space)
"f" = (
/obj/structure/cable,
/obj/machinery/portable_atmospherics/canister,
/obj/machinery/atmospherics/components/unary/portables_connector/visible/layer2{
	dir = 4
	},
/turf/open/floor/iron/shuttle/cargo,
/area/space)
"g" = (
/obj/structure/table/reinforced,
/obj/effect/spawner/random/medical/medkit,
/turf/open/floor/iron/shuttle/cargo,
/area/space)
"h" = (
/turf/closed/wall/mineral/titanium/spaceship,
/area/space)
"i" = (
/obj/structure/cable,
/obj/machinery/atmospherics/pipe/smart/manifold4w/scrubbers/hidden/layer2,
/obj/machinery/atmospherics/pipe/smart/manifold4w/supply/hidden/layer4,
/turf/open/floor/catwalk_floor/iron_dark,
/area/space)
"j" = (
/obj/machinery/door/poddoor/preopen,
/turf/open/floor/plating/reinforced,
/area/space)
"k" = (
/obj/structure/tank_dispenser,
/obj/machinery/airalarm/directional/south,
/obj/effect/mapping_helpers/airalarm/all_access,
/turf/open/floor/iron/shuttle/cargo,
/area/space)
"l" = (
/obj/structure/cable,
/turf/open/floor/catwalk_floor/iron_dark,
/area/space)
"m" = (
/obj/effect/spawner/structure/window/reinforced/plasma/plastitanium,
/turf/open/floor/plating/reinforced,
/area/space)
"n" = (
/obj/machinery/atmospherics/pipe/smart/manifold4w/scrubbers/hidden/layer2,
/turf/open/floor/iron/shuttle/cargo,
/area/space)
"o" = (
/obj/structure/window/reinforced/plasma/spawner/directional/west,
/turf/open/floor/engine,
/area/space)
"q" = (
/obj/structure/rack/shelf,
/obj/item/crowbar/red,
/obj/item/crowbar/red,
/turf/open/floor/iron/shuttle/cargo,
/area/space)
"r" = (
/obj/structure/window/reinforced/plasma/spawner/directional/east,
/turf/open/floor/engine,
/area/space)
"s" = (
/obj/machinery/suit_storage_unit/industrial/tarkon,
/turf/open/floor/iron/shuttle/cargo,
/area/space)
"t" = (
/obj/structure/cable,
/obj/machinery/space_heater/wall_mounted/directional/south,
/turf/open/floor/catwalk_floor/iron_dark,
/area/space)
"u" = (
/obj/machinery/door/window/brigdoor/left/directional/west,
/obj/machinery/atmospherics/pipe/smart/manifold4w/supply/hidden/layer4,
/obj/machinery/atmospherics/pipe/smart/manifold4w/scrubbers/hidden/layer2,
/turf/open/floor/catwalk_floor/iron_dark,
/area/space)
"v" = (
/obj/machinery/power/apc/auto_name/directional/north,
/obj/structure/cable,
/turf/open/floor/iron/shuttle/cargo,
/area/space)
"w" = (
/obj/structure/cable,
/turf/open/floor/iron/shuttle/cargo,
/area/space)
"x" = (
/turf/template_noop,
/area/space)
"z" = (
/obj/machinery/computer/camera_advanced/tarkon_cam{
	dir = 8
	},
/turf/open/floor/iron/shuttle/cargo,
/area/space)
"A" = (
/obj/machinery/atmospherics/components/unary/vent_scrubber/on/layer2{
	dir = 1
	},
/turf/open/floor/iron/shuttle/cargo,
/area/space)
"B" = (
/obj/structure/table/reinforced,
/obj/item/reagent_containers/condiment/milk/small_ration,
/obj/item/food/cookie,
/turf/open/floor/iron/shuttle/cargo,
/area/space)
"C" = (
/obj/structure/window/reinforced/plasma/spawner/directional/west,
/obj/effect/turf_decal/stripes{
	dir = 1
	},
/turf/open/floor/engine,
/area/space)
"D" = (
/obj/structure/cable,
/obj/machinery/atmospherics/pipe/smart/manifold4w/scrubbers/hidden/layer2,
/turf/open/floor/catwalk_floor/iron_dark,
/area/space)
"E" = (
/obj/machinery/atmospherics/components/unary/vent_scrubber/on/layer2{
	dir = 4
	},
/turf/open/floor/iron/shuttle/cargo,
/area/space)
"F" = (
/obj/machinery/door/airlock/highsecurity,
/obj/structure/fans/tiny,
/obj/structure/cable,
/obj/docking_port/mobile/tarkon_salvageskiff,
/turf/open/floor/iron/shuttle/cargo,
/area/space)
"G" = (
/obj/structure/chair/comfy/shuttle{
	dir = 4
	},
/turf/open/floor/iron/shuttle/cargo,
/area/space)
"H" = (
/obj/structure/cable,
/obj/machinery/atmospherics/pipe/smart/manifold4w/supply/hidden/layer4,
/obj/machinery/atmospherics/pipe/smart/manifold4w/scrubbers/hidden/layer2,
/turf/open/floor/catwalk_floor/iron_dark,
/area/space)
"I" = (
/obj/structure/table/reinforced/titaniumglass,
/obj/effect/spawner/random/food_or_drink/donkpockets,
/obj/effect/spawner/random/food_or_drink/donkpockets,
/turf/open/floor/iron/shuttle/cargo,
/area/space)
"J" = (
/obj/machinery/atmospherics/components/unary/vent_pump/on/layer4{
	dir = 1
	},
/turf/open/floor/iron/shuttle/cargo,
/area/space)
"K" = (
/obj/structure/window/reinforced/plasma/spawner/directional/east,
/obj/effect/turf_decal/stripes{
	dir = 1
	},
/turf/open/floor/engine,
/area/space)
"L" = (
/obj/machinery/atmospherics/pipe/smart/manifold4w/supply/hidden/layer4,
/obj/machinery/atmospherics/pipe/smart/manifold4w/scrubbers/hidden/layer2,
/turf/open/floor/catwalk_floor/iron_dark,
/area/space)
"M" = (
/obj/structure/window/reinforced/spawner/directional/west,
/turf/open/floor/iron/shuttle/cargo,
/area/space)
"N" = (
/obj/machinery/power/shuttle_engine/propulsion/burst{
	dir = 8
	},
/turf/template_noop,
/area/space)
"O" = (
/obj/structure/window/reinforced/spawner/directional/west,
/obj/machinery/atmospherics/components/unary/vent_scrubber/on/layer2,
/obj/structure/closet/emcloset/wall{
	pixel_y = 30
	},
/obj/item/oxygen_candle,
/turf/open/floor/iron/shuttle/cargo,
/area/space)
"P" = (
/obj/machinery/power/smes/battery_pack/large,
/obj/structure/cable,
/turf/open/floor/iron/shuttle/cargo,
/area/space)
"R" = (
/obj/machinery/computer/shuttle/tarkon_driver{
	dir = 8
	},
/turf/open/floor/iron/shuttle/cargo,
/area/space)
"T" = (
/obj/machinery/cell_charger_multi/wall_mounted/directional/north,
/turf/open/floor/iron/shuttle/cargo,
/area/space)
"U" = (
/obj/machinery/atmospherics/pipe/smart/manifold4w/supply/hidden/layer4,
/turf/open/floor/iron/shuttle/cargo,
/area/space)
"V" = (
/obj/structure/chair/comfy/shuttle,
/turf/open/floor/iron/shuttle/cargo,
/area/space)
"X" = (
/obj/machinery/power/terminal{
	dir = 8
	},
/obj/structure/cable,
/turf/open/floor/catwalk_floor/iron_dark,
/area/space)
"Y" = (
/obj/machinery/computer/camera_advanced/shuttle_docker/tarkon_driver{
	dir = 8
	},
/turf/open/floor/iron/shuttle/cargo,
/area/space)
"Z" = (
/obj/structure/window/reinforced/spawner/directional/west,
/obj/structure/chair/comfy/shuttle{
	dir = 4
	},
/turf/open/floor/iron/shuttle/cargo,
/area/space)

(1,1,1) = {"
x
N
N
x
N
N
x
"}
(2,1,1) = {"
h
a
a
h
a
a
h
"}
(3,1,1) = {"
h
v
w
e
f
P
h
"}
(4,1,1) = {"
h
d
E
U
n
X
h
"}
(5,1,1) = {"
j
d
H
i
D
t
h
"}
(6,1,1) = {"
j
d
H
J
C
o
h
"}
(7,1,1) = {"
j
d
H
d
K
r
h
"}
(8,1,1) = {"
h
d
H
d
d
s
h
"}
(9,1,1) = {"
h
T
H
A
q
k
h
"}
(10,1,1) = {"
h
d
H
d
d
s
h
"}
(11,1,1) = {"
F
l
H
d
M
Z
m
"}
(12,1,1) = {"
h
d
L
J
V
I
m
"}
(13,1,1) = {"
h
d
L
d
V
b
m
"}
(14,1,1) = {"
h
O
u
c
h
h
h
"}
(15,1,1) = {"
m
B
G
g
m
x
x
"}
(16,1,1) = {"
m
z
Y
R
m
x
x
"}
(17,1,1) = {"
h
m
m
m
h
x
x
"}
