//MAP CONVERTED BY dmm2tgm.py THIS HEADER COMMENT PREVENTS RECONVERSION, DO NOT REMOVE
"a" = (
/turf/template_noop,
/area/space)
"b" = (
/obj/structure/rack/gunrack,
/obj/item/gun/ballistic/automatic/sol_smg/no_mag,
/turf/template_noop,
/area/space)
"e" = (
/obj/structure/rack,
/obj/item/ammo_box/magazine/c35sol_pistol/stendo/starts_empty,
/obj/item/ammo_box/magazine/c35sol_pistol/stendo/starts_empty,
/turf/template_noop,
/area/space)
"h" = (
/obj/item/ammo_box/magazine/c40sol_rifle/standard,
/obj/item/ammo_box/magazine/c40sol_rifle,
/obj/item/ammo_box/magazine/c40sol_rifle,
/turf/template_noop,
/area/space)
"i" = (
/obj/structure/rack/shelf,
/obj/item/ammo_box/advanced/s12gauge/express,
/obj/item/ammo_box/advanced/s12gauge/express,
/obj/item/ammo_box/advanced/s12gauge/buckshot,
/obj/item/ammo_box/advanced/s12gauge/buckshot,
/turf/template_noop,
/area/space)
"j" = (
/obj/item/gun/ballistic/automatic/sol_rifle/machinegun/no_mag,
/turf/template_noop,
/area/space)
"k" = (
/obj/structure/rack,
/turf/template_noop,
/area/space)
"r" = (
/obj/structure/table/reinforced,
/turf/template_noop,
/area/space)
"s" = (
/obj/structure/rack/gunrack,
/obj/item/gun/ballistic/shotgun/riot/sol,
/turf/template_noop,
/area/space)
"I" = (
/obj/structure/rack/shelf,
/obj/item/ammo_box/advanced/s12gauge/rubber,
/obj/item/ammo_box/advanced/s12gauge/rubber,
/turf/template_noop,
/area/space)
"O" = (
/obj/item/gun/ballistic/automatic/sol_rifle/no_mag,
/turf/template_noop,
/area/space)

(1,1,1) = {"
a
a
a
a
a
a
a
a
a
a
"}
(2,1,1) = {"
a
a
a
a
a
i
I
s
b
a
"}
(3,1,1) = {"
a
a
a
a
a
a
a
a
a
a
"}
(4,1,1) = {"
a
a
a
a
a
r
a
a
a
a
"}
(5,1,1) = {"
a
j
a
O
a
r
e
a
a
a
"}
(6,1,1) = {"
a
a
a
a
a
r
a
a
a
a
"}
(7,1,1) = {"
a
a
a
a
a
a
a
a
a
a
"}
(8,1,1) = {"
a
h
h
a
a
r
r
k
r
a
"}
(9,1,1) = {"
a
a
a
a
a
a
a
a
a
a
"}
