//MAP CONVERTED BY dmm2tgm.py THIS HEADER COMMENT PREVENTS RECONVERSION, DO NOT REMOVE
"a" = (
/turf/open/floor/grass/fairy,
/area/ruin/hermit_fishing)
"b" = (
/obj/structure/mineral_door/manual_colony_door,
/turf/open/floor/plating/snowed/smoothed,
/area/ruin/hermit_fishing)
"c" = (
/obj/item/shovel,
/turf/open/floor/grass/fairy,
/area/ruin/hermit_fishing)
"d" = (
/obj/effect/turf_decal/siding/wood{
	dir = 1
	},
/turf/open/floor/wood,
/area/ruin/hermit_fishing)
"e" = (
/obj/item/cultivator/rake,
/turf/open/floor/grass/fairy,
/area/ruin/hermit_fishing)
"f" = (
/obj/machinery/hydroponics/soil,
/obj/item/seeds/reishi,
/turf/open/floor/grass/fairy,
/area/ruin/hermit_fishing)
"g" = (
/turf/closed/wall/mineral/wood,
/area/ruin/hermit_fishing)
"h" = (
/obj/structure/window/green_glass_pane,
/obj/structure/curtain/bounty/start_closed,
/turf/open/floor/wood,
/area/ruin/hermit_fishing)
"i" = (
/obj/effect/turf_decal/siding/wood{
	dir = 5
	},
/obj/structure/closet/crate/wooden/storage_barrel,
/turf/open/floor/wood,
/area/ruin/hermit_fishing)
"j" = (
/obj/effect/turf_decal/siding/wood,
/obj/structure/table/wood,
/obj/item/knife/combat,
/turf/open/floor/wood,
/area/ruin/hermit_fishing)
"k" = (
/obj/effect/turf_decal/siding/wood{
	dir = 10
	},
/obj/structure/railing/corner{
	dir = 4
	},
/turf/open/floor/stone,
/area/ruin/hermit_fishing)
"l" = (
/obj/effect/turf_decal/siding/wood{
	dir = 4
	},
/obj/structure/railing{
	dir = 8
	},
/turf/open/floor/stone,
/area/ruin/hermit_fishing)
"m" = (
/obj/effect/turf_decal/siding/wood{
	dir = 4
	},
/obj/effect/turf_decal/siding/wood{
	dir = 8
	},
/obj/effect/turf_decal/siding/wood,
/obj/effect/turf_decal/siding/wood/corner{
	dir = 8
	},
/obj/effect/turf_decal/siding/wood/corner,
/turf/open/floor/wood,
/area/ruin/hermit_fishing)
"o" = (
/obj/effect/turf_decal/siding/wood,
/obj/effect/mob_spawn/ghost_role/human/fisher_hermit,
/turf/open/floor/carpet/red,
/area/ruin/hermit_fishing)
"p" = (
/obj/structure/bonfire/dense/prelit,
/turf/open/floor/stone,
/area/ruin/hermit_fishing)
"q" = (
/obj/machinery/portable_atmospherics/canister/oxygen,
/obj/effect/turf_decal/siding/wood{
	dir = 6
	},
/turf/open/floor/wood,
/area/ruin/hermit_fishing)
"r" = (
/obj/structure/glowshroom/single,
/turf/open/floor/grass/fairy,
/area/ruin/hermit_fishing)
"t" = (
/obj/item/reagent_containers/cup/bucket/wooden,
/turf/open/floor/grass/fairy,
/area/ruin/hermit_fishing)
"u" = (
/obj/effect/turf_decal/siding/wood{
	dir = 1
	},
/obj/structure/bed/double/pod{
	dir = 1
	},
/obj/effect/spawner/random/bedsheet/any/double{
	dir = 1
	},
/turf/open/floor/carpet/red,
/area/ruin/hermit_fishing)
"v" = (
/obj/structure/table/wood,
/obj/item/flashlight/lantern/on,
/obj/effect/turf_decal/siding/wood{
	dir = 9
	},
/turf/open/floor/wood,
/area/ruin/hermit_fishing)
"w" = (
/turf/open/water/beach,
/area/ruin/hermit_fishing)
"x" = (
/obj/structure/mineral_door/manual_colony_door,
/turf/open/floor/plating,
/area/ruin/hermit_fishing)
"y" = (
/turf/open/water/deep_beach,
/area/ruin/hermit_fishing)
"z" = (
/obj/structure/closet/cabinet,
/obj/item/clothing/suit/hooded/wintercoat,
/obj/effect/turf_decal/siding/wood{
	dir = 1
	},
/turf/open/floor/wood,
/area/ruin/hermit_fishing)
"B" = (
/obj/effect/turf_decal/siding/wood{
	dir = 6
	},
/obj/structure/railing/corner{
	dir = 1
	},
/turf/open/floor/stone,
/area/ruin/hermit_fishing)
"C" = (
/obj/structure/aquarium/prefilled,
/obj/effect/turf_decal/siding/wood{
	dir = 1
	},
/turf/open/floor/wood,
/area/ruin/hermit_fishing)
"D" = (
/obj/effect/turf_decal/siding/wood,
/turf/open/floor/wood,
/area/ruin/hermit_fishing)
"E" = (
/obj/structure/table/wood,
/obj/effect/turf_decal/siding/wood,
/obj/item/tank/internals/emergency_oxygen/engi,
/turf/open/floor/wood,
/area/ruin/hermit_fishing)
"F" = (
/obj/effect/turf_decal/siding/wood{
	dir = 4
	},
/obj/effect/turf_decal/siding/wood{
	dir = 8
	},
/obj/effect/turf_decal/siding/wood{
	dir = 1
	},
/obj/effect/turf_decal/siding/wood/corner{
	dir = 1
	},
/obj/effect/turf_decal/siding/wood/corner{
	dir = 4
	},
/turf/open/floor/wood,
/area/ruin/hermit_fishing)
"G" = (
/obj/machinery/hydroponics/soil,
/obj/item/seeds/plump,
/turf/open/floor/grass/fairy,
/area/ruin/hermit_fishing)
"H" = (
/turf/template_noop,
/area/template_noop)
"I" = (
/obj/effect/turf_decal/siding/wood{
	dir = 5
	},
/turf/open/floor/carpet/red,
/area/ruin/hermit_fishing)
"J" = (
/obj/effect/turf_decal/siding/wood{
	dir = 10
	},
/turf/open/floor/wood,
/area/ruin/hermit_fishing)
"K" = (
/obj/structure/mineral_door/manual_colony_door,
/turf/open/floor/wood,
/area/ruin/hermit_fishing)
"L" = (
/turf/open/floor/wood,
/area/ruin/hermit_fishing)
"M" = (
/obj/effect/turf_decal/siding/wood{
	dir = 4
	},
/obj/effect/turf_decal/siding/wood{
	dir = 8
	},
/turf/open/floor/wood,
/area/ruin/hermit_fishing)
"O" = (
/turf/closed/wall/mineral/snow,
/area/ruin/hermit_fishing)
"P" = (
/obj/structure/table/wood,
/obj/item/storage/box/fishing_lures,
/obj/effect/turf_decal/siding/wood{
	dir = 4
	},
/obj/item/fishing_rod/unslotted,
/obj/item/fishing_line,
/obj/item/fishing_hook,
/turf/open/floor/wood,
/area/ruin/hermit_fishing)
"Q" = (
/obj/machinery/hydroponics/soil,
/obj/item/seeds/glowshroom,
/turf/open/floor/grass/fairy,
/area/ruin/hermit_fishing)
"R" = (
/obj/item/pickaxe/improvised,
/obj/structure/fans/tiny/invisible,
/obj/item/clothing/mask/gas,
/obj/structure/closet/generic/wall/empty{
	pixel_y = 27
	},
/turf/open/floor/plating/snowed/smoothed,
/area/ruin/hermit_fishing)
"S" = (
/obj/effect/turf_decal/siding/wood,
/obj/structure/railing{
	dir = 1
	},
/turf/open/floor/stone,
/area/ruin/hermit_fishing)
"T" = (
/obj/effect/turf_decal/siding/wood{
	dir = 8
	},
/obj/structure/railing{
	dir = 4
	},
/turf/open/floor/stone,
/area/ruin/hermit_fishing)
"U" = (
/obj/effect/turf_decal/siding/wood{
	dir = 6
	},
/turf/open/floor/carpet/red,
/area/ruin/hermit_fishing)
"V" = (
/turf/closed/wall/mineral/stone,
/area/ruin/hermit_fishing)
"X" = (
/obj/machinery/hydroponics/soil,
/obj/item/seeds/tower,
/turf/open/floor/grass/fairy,
/area/ruin/hermit_fishing)
"Y" = (
/obj/structure/table/wood,
/obj/item/storage/toolbox/emergency,
/obj/effect/turf_decal/siding/wood{
	dir = 4
	},
/turf/open/floor/wood,
/area/ruin/hermit_fishing)
"Z" = (
/obj/structure/flora/tree/jungle/small/style_random,
/turf/open/floor/grass/fairy,
/area/ruin/hermit_fishing)

(1,1,1) = {"
H
H
H
H
H
H
H
H
O
b
O
H
H
H
H
H
"}
(2,1,1) = {"
H
H
H
H
H
H
H
H
O
R
O
H
H
H
H
H
"}
(3,1,1) = {"
H
H
H
H
H
H
H
O
O
x
O
O
O
O
H
H
"}
(4,1,1) = {"
H
g
g
g
g
g
g
O
r
a
a
a
a
O
O
H
"}
(5,1,1) = {"
H
g
v
u
o
J
g
a
a
a
a
a
Z
r
O
H
"}
(6,1,1) = {"
H
g
z
I
U
D
g
a
Z
a
w
w
a
a
O
H
"}
(7,1,1) = {"
H
g
d
L
L
D
h
a
a
w
w
w
w
a
O
H
"}
(8,1,1) = {"
H
V
T
k
L
D
g
a
a
w
y
y
w
a
O
H
"}
(9,1,1) = {"
H
V
p
S
L
D
K
a
F
M
m
y
w
a
O
H
"}
(10,1,1) = {"
H
V
l
B
L
E
g
a
a
w
y
y
w
a
O
H
"}
(11,1,1) = {"
H
g
d
L
L
j
g
a
a
w
w
w
w
a
O
H
"}
(12,1,1) = {"
H
g
C
L
L
D
g
G
e
t
w
w
a
a
O
H
"}
(13,1,1) = {"
H
g
i
P
Y
q
g
G
r
c
a
a
Z
a
O
H
"}
(14,1,1) = {"
H
g
g
g
g
g
g
O
Q
X
f
a
r
O
O
H
"}
(15,1,1) = {"
H
H
H
H
H
H
H
O
O
O
O
O
O
O
H
H
"}
(16,1,1) = {"
H
H
H
H
H
H
H
H
H
H
H
H
H
H
H
H
"}
