//MAP CONVERTED BY dmm2tgm.py THIS HEADER COMMENT PREVENTS RECONVERSION, DO NOT REMOVE
"a" = (
/obj/item/hatchet/wooden,
/turf/open/misc/asteroid/snow/icemoon,
/area/icemoon/underground/explored)
"b" = (
/obj/structure/closet/generic/wall/empty{
	pixel_y = 28
	},
/obj/item/storage/toolbox/emergency,
/obj/item/storage/medkit/emergency,
/obj/item/knife/hunting,
/turf/open/floor/iron/colony/white,
/area/ruin/powered/hermit)
"d" = (
/obj/structure/water_source/brick_well,
/turf/open/misc/asteroid/snow/icemoon,
/area/icemoon/underground/explored)
"e" = (
/obj/machinery/pipedispenser,
/turf/open/floor/iron/colony/white,
/area/ruin/powered/hermit)
"f" = (
/obj/structure/railing/wooden_fencing{
	dir = 8
	},
/obj/structure/railing/wooden_fencing,
/obj/structure/glowshroom/single,
/turf/open/misc/asteroid/snow/icemoon,
/area/icemoon/underground/explored)
"h" = (
/obj/machinery/hydroponics/soil,
/obj/item/seeds/plump,
/turf/open/misc/asteroid/snow/icemoon,
/area/icemoon/underground/explored)
"j" = (
/obj/structure/railing/wooden_fencing{
	dir = 8
	},
/obj/machinery/hydroponics/soil,
/turf/open/misc/asteroid/snow/icemoon,
/area/icemoon/underground/explored)
"k" = (
/turf/closed/mineral/snowmountain/icemoon/unscrapeable,
/area/icemoon/underground/explored)
"l" = (
/obj/machinery/atmospherics/components/unary/portables_connector,
/obj/machinery/portable_atmospherics/pump,
/turf/open/floor/iron/colony/white,
/area/ruin/powered/hermit)
"p" = (
/turf/open/floor/iron/colony/white,
/area/ruin/powered/hermit)
"r" = (
/obj/machinery/atmospherics/pipe/smart/manifold4w/general/hidden,
/turf/open/floor/iron/colony/white/texture,
/area/ruin/powered/hermit)
"s" = (
/obj/structure/rack/shelf,
/obj/item/tank/internals/emergency_oxygen/engi,
/obj/item/pickaxe/emergency,
/obj/item/stack/sheet/plastic_wall_panel/ten,
/obj/item/storage/bag/ore,
/turf/open/floor/iron/colony/white,
/area/ruin/powered/hermit)
"t" = (
/obj/machinery/door/poddoor/shutters/colony_fabricator{
	id = "skiffwindows"
	},
/turf/open/floor/iron/colony/white,
/area/ruin/powered/hermit)
"w" = (
/obj/item/cultivator/rake,
/turf/open/misc/asteroid/snow/icemoon,
/area/icemoon/underground/explored)
"x" = (
/obj/item/wallframe/apc,
/obj/item/stock_parts/power_store/battery/high/empty,
/obj/structure/closet/crate,
/obj/item/flatpacked_machine/wind_turbine,
/obj/item/flatpacked_machine/station_battery,
/turf/open/floor/iron/colony/white,
/area/ruin/powered/hermit)
"y" = (
/obj/structure/window/fulltile/colony_fabricator,
/obj/machinery/door/poddoor/shutters/colony_fabricator{
	id = "pod_shutter"
	},
/obj/structure/barricade/wooden/crude/snow,
/turf/open/floor/iron/colony/white,
/area/ruin/powered/hermit)
"z" = (
/obj/machinery/door/airlock/titanium{
	name = "Escape Pod Airlock"
	},
/turf/closed/mineral/snowmountain/icemoon/unscrapeable,
/area/icemoon/underground/explored)
"A" = (
/obj/item/hatchet/wooden,
/turf/closed/mineral/snowmountain/icemoon/unscrapeable,
/area/icemoon/underground/explored)
"C" = (
/obj/machinery/portable_atmospherics/canister/oxygen,
/turf/open/floor/iron/colony/white,
/area/ruin/powered/hermit)
"D" = (
/obj/item/shovel,
/turf/open/misc/asteroid/snow/icemoon,
/area/icemoon/underground/explored)
"E" = (
/obj/machinery/hydroponics/soil,
/obj/item/seeds/glowshroom,
/turf/open/misc/asteroid/snow/icemoon,
/area/icemoon/underground/explored)
"F" = (
/obj/structure/mineral_door/manual_colony_door,
/obj/structure/barricade/wooden/crude/snow,
/turf/open/floor/iron/colony/white/texture,
/area/ruin/powered/hermit)
"G" = (
/turf/closed/wall/prefab_plastic,
/area/ruin/powered/hermit)
"H" = (
/obj/machinery/smartfridge/survival_pod/preloaded,
/turf/open/floor/iron/colony/white,
/area/ruin/powered/hermit)
"I" = (
/turf/closed/wall/mineral/titanium/spaceship,
/area/ruin/powered/hermit)
"J" = (
/obj/machinery/portable_atmospherics/canister/air,
/obj/machinery/atmospherics/components/unary/portables_connector,
/turf/open/floor/iron/colony/white,
/area/ruin/powered/hermit)
"K" = (
/obj/effect/mob_spawn/ghost_role/human/crashed_hermit,
/turf/open/floor/iron/colony/white,
/area/ruin/powered/hermit)
"L" = (
/obj/machinery/power/shuttle_engine/propulsion/burst{
	dir = 8
	},
/turf/closed/mineral/snowmountain/icemoon/unscrapeable,
/area/icemoon/underground/explored)
"M" = (
/obj/structure/fluff/empty_cryostasis_sleeper,
/turf/open/floor/iron/colony/white,
/area/ruin/powered/hermit)
"N" = (
/obj/structure/mineral_door/manual_colony_door,
/turf/open/floor/iron/colony/white/texture,
/area/ruin/powered/hermit)
"O" = (
/turf/open/misc/asteroid/snow/icemoon,
/area/icemoon/underground/explored)
"P" = (
/turf/open/floor/iron/colony/white/texture,
/area/ruin/powered/hermit)
"Q" = (
/obj/machinery/button/door{
	pixel_y = -28;
	id = "pod_shutter"
	},
/turf/open/floor/iron/colony/white,
/area/ruin/powered/hermit)
"R" = (
/obj/item/reagent_containers/cup/jerrycan/opaque,
/turf/open/misc/asteroid/snow/icemoon,
/area/icemoon/underground/explored)
"S" = (
/obj/machinery/button/door{
	pixel_x = 8;
	id = "skiffwindows"
	},
/turf/closed/wall/prefab_plastic,
/area/ruin/powered/hermit)
"U" = (
/obj/structure/flora/tree/stump,
/turf/open/misc/asteroid/snow/icemoon,
/area/icemoon/underground/explored)
"V" = (
/obj/machinery/power/shuttle_engine/propulsion/burst{
	dir = 8
	},
/turf/closed/wall/mineral/titanium/spaceship,
/area/ruin/powered/hermit)
"X" = (
/obj/structure/chair{
	dir = 4
	},
/turf/closed/mineral/snowmountain/icemoon/unscrapeable,
/area/icemoon/underground/explored)
"Z" = (
/turf/template_noop,
/area/template_noop)

(1,1,1) = {"
Z
k
k
k
k
k
k
k
Z
Z
Z
Z
Z
Z
Z
Z
"}
(2,1,1) = {"
k
k
V
I
I
I
V
O
O
Z
Z
Z
Z
Z
Z
Z
"}
(3,1,1) = {"
k
V
I
K
H
M
I
V
O
k
k
k
k
Z
Z
Z
"}
(4,1,1) = {"
k
I
p
p
P
p
Q
I
O
j
j
f
k
k
Z
Z
"}
(5,1,1) = {"
k
G
p
P
P
P
p
y
O
O
O
E
f
k
k
Z
"}
(6,1,1) = {"
k
G
p
P
p
P
p
y
O
w
O
O
h
O
k
Z
"}
(7,1,1) = {"
A
G
p
P
p
p
x
G
O
d
D
O
h
O
k
Z
"}
(8,1,1) = {"
k
G
b
P
p
G
G
G
O
O
R
O
O
U
k
Z
"}
(9,1,1) = {"
k
G
p
P
P
N
P
F
O
O
O
O
O
O
k
Z
"}
(10,1,1) = {"
k
G
l
r
p
S
G
G
O
O
O
a
O
O
k
Z
"}
(11,1,1) = {"
k
G
e
r
p
p
s
G
O
O
O
O
O
O
k
Z
"}
(12,1,1) = {"
k
G
J
r
p
P
C
G
O
U
O
O
O
O
k
Z
"}
(13,1,1) = {"
k
I
p
P
P
P
p
I
O
O
O
O
z
L
k
Z
"}
(14,1,1) = {"
k
t
t
p
P
p
t
t
k
k
k
k
X
Z
Z
Z
"}
(15,1,1) = {"
k
k
t
t
t
t
t
k
k
Z
Z
Z
Z
Z
Z
Z
"}
(16,1,1) = {"
Z
k
k
k
k
k
k
k
Z
Z
Z
Z
Z
Z
Z
Z
"}
