//MAP CONVERTED BY dmm2tgm.py THIS HEADER COMMENT PREVENTS RECONVERSION, DO NOT REMOVE
"a" = (
/obj/item/hatchet/wooden,
/turf/open/misc/asteroid/snow/icemoon,
/area/icemoon/underground/explored)
"b" = (
/obj/structure/closet/generic/wall/empty{
	pixel_y = 28
	},
/obj/item/storage/toolbox/emergency,
/obj/item/storage/medkit/emergency,
/obj/item/knife/hunting,
/turf/open/floor/iron/colony/white,
/area/ruin/powered/hermit)
"d" = (
/obj/structure/water_source/brick_well,
/turf/open/misc/asteroid/snow/icemoon,
/area/icemoon/underground/explored)
"e" = (
/obj/machinery/pipedispenser,
/turf/open/floor/iron/colony/white,
/area/ruin/powered/hermit)
"f" = (
/obj/structure/railing/wooden_fencing{
	dir = 8
	},
/obj/structure/railing/wooden_fencing,
/obj/structure/glowshroom/single,
/turf/open/misc/asteroid/snow/icemoon,
/area/icemoon/underground/explored)
"h" = (
/obj/machinery/hydroponics/soil,
/obj/item/seeds/plump,
/turf/open/misc/asteroid/snow/icemoon,
/area/icemoon/underground/explored)
"j" = (
/obj/structure/railing/wooden_fencing{
	dir = 8
	},
/obj/machinery/hydroponics/soil,
/turf/open/misc/asteroid/snow/icemoon,
/area/icemoon/underground/explored)
"k" = (
/turf/closed/mineral/snowmountain/icemoon/unscrapeable,
/area/icemoon/underground/explored)
"l" = (
/obj/machinery/atmospherics/components/unary/portables_connector,
/obj/machinery/portable_atmospherics/pump,
/turf/open/floor/iron/colony/white,
/area/ruin/powered/hermit)
"p" = (
/turf/open/floor/iron/colony/white,
/area/ruin/powered/hermit)
"r" = (
/obj/machinery/atmospherics/pipe/smart/manifold4w/general/hidden,
/turf/open/floor/iron/colony/white/texture,
/area/ruin/powered/hermit)
"s" = (
/obj/structure/rack/shelf,
/obj/item/tank/internals/emergency_oxygen/engi,
/obj/item/pickaxe/emergency,
/obj/item/stack/sheet/plastic_wall_panel/ten,
/obj/item/storage/bag/ore,
/turf/open/floor/iron/colony/white,
/area/ruin/powered/hermit)
"t" = (
/obj/effect/mob_spawn/ghost_role/human/better_hermit,
/turf/open/floor/iron/colony/white,
/area/ruin/powered/hermit)
"w" = (
/obj/item/cultivator/rake,
/turf/open/misc/asteroid/snow/icemoon,
/area/icemoon/underground/explored)
"x" = (
/obj/item/wallframe/apc,
/obj/item/stock_parts/power_store/battery/high/empty,
/obj/structure/closet/crate,
/obj/item/flatpacked_machine/wind_turbine,
/obj/item/flatpacked_machine/station_battery,
/turf/open/floor/iron/colony/white,
/area/ruin/powered/hermit)
"y" = (
/obj/structure/window/fulltile/colony_fabricator,
/obj/machinery/door/poddoor/shutters/colony_fabricator{
	id = "pod_shutter"
	},
/obj/structure/barricade/wooden/crude/snow,
/turf/open/floor/iron/colony/white,
/area/ruin/powered/hermit)
"z" = (
/obj/machinery/door/airlock/titanium{
	name = "Escape Pod Airlock"
	},
/turf/open/floor/mineral/titanium/blue,
/area/icemoon/underground/explored)
"A" = (
/obj/item/hatchet/wooden,
/turf/closed/mineral/snowmountain/icemoon/unscrapeable,
/area/icemoon/underground/explored)
"C" = (
/obj/machinery/portable_atmospherics/canister/oxygen,
/turf/open/floor/iron/colony/white,
/area/ruin/powered/hermit)
"D" = (
/obj/item/shovel,
/turf/open/misc/asteroid/snow/icemoon,
/area/icemoon/underground/explored)
"E" = (
/obj/machinery/hydroponics/soil,
/obj/item/seeds/glowshroom,
/turf/open/misc/asteroid/snow/icemoon,
/area/icemoon/underground/explored)
"F" = (
/obj/structure/mineral_door/manual_colony_door,
/obj/structure/barricade/wooden/crude/snow,
/turf/open/floor/iron/colony/white/texture,
/area/ruin/powered/hermit)
"G" = (
/turf/closed/wall/prefab_plastic,
/area/ruin/powered/hermit)
"H" = (
/obj/structure/railing/wooden_fencing{
	dir = 8
	},
/turf/open/misc/asteroid/snow/icemoon,
/area/icemoon/underground/explored)
"I" = (
/obj/effect/spawner/structure/window/reinforced/shuttle,
/turf/open/floor/plating{
	initial_gas_mix = "LAVALAND_ATMOS"
	},
/area/icemoon/underground/explored)
"J" = (
/obj/machinery/portable_atmospherics/canister/air,
/obj/machinery/atmospherics/components/unary/portables_connector,
/turf/open/floor/iron/colony/white,
/area/ruin/powered/hermit)
"K" = (
/turf/closed/wall/mineral/titanium,
/area/icemoon/underground/explored)
"L" = (
/obj/machinery/power/shuttle_engine/propulsion/burst{
	dir = 8
	},
/turf/closed/wall/mineral/titanium/interior,
/area/icemoon/underground/explored)
"M" = (
/obj/machinery/atmospherics/pipe/smart/manifold4w/general/hidden,
/turf/open/floor/iron/colony/white,
/area/ruin/powered/hermit)
"N" = (
/obj/structure/mineral_door/manual_colony_door,
/turf/open/floor/iron/colony/white/texture,
/area/ruin/powered/hermit)
"O" = (
/turf/open/misc/asteroid/snow/icemoon,
/area/icemoon/underground/explored)
"P" = (
/turf/open/floor/iron/colony/white/texture,
/area/ruin/powered/hermit)
"Q" = (
/obj/machinery/button/door{
	pixel_y = -28;
	id = "pod_shutter"
	},
/turf/open/floor/iron/colony/white,
/area/ruin/powered/hermit)
"R" = (
/obj/item/reagent_containers/cup/jerrycan/opaque,
/turf/open/misc/asteroid/snow/icemoon,
/area/icemoon/underground/explored)
"S" = (
/turf/closed/wall/mineral/titanium/interior,
/area/icemoon/underground/explored)
"U" = (
/obj/structure/flora/tree/stump,
/turf/open/misc/asteroid/snow/icemoon,
/area/icemoon/underground/explored)
"V" = (
/obj/structure/railing/wooden_fencing{
	dir = 8
	},
/obj/structure/railing/wooden_fencing{
	dir = 1
	},
/obj/machinery/hydroponics/soil,
/turf/open/misc/asteroid/snow/icemoon,
/area/icemoon/underground/explored)
"X" = (
/obj/structure/chair{
	dir = 4
	},
/turf/open/floor/mineral/titanium/blue,
/area/icemoon/underground/explored)
"Z" = (
/turf/template_noop,
/area/template_noop)

(1,1,1) = {"
Z
Z
Z
Z
Z
Z
Z
Z
Z
Z
Z
Z
Z
Z
Z
Z
"}
(2,1,1) = {"
Z
Z
Z
Z
Z
Z
Z
Z
Z
Z
Z
Z
Z
Z
Z
Z
"}
(3,1,1) = {"
k
k
k
k
k
k
k
k
k
k
k
k
k
Z
Z
Z
"}
(4,1,1) = {"
k
G
G
G
G
G
G
G
k
V
j
f
k
k
Z
Z
"}
(5,1,1) = {"
k
G
p
t
p
p
Q
G
H
O
O
E
f
k
k
Z
"}
(6,1,1) = {"
k
G
p
P
P
P
p
y
O
w
O
O
h
O
k
Z
"}
(7,1,1) = {"
k
G
p
P
p
p
p
y
O
d
D
O
h
O
k
Z
"}
(8,1,1) = {"
A
G
p
P
p
p
x
G
O
O
R
O
O
U
k
Z
"}
(9,1,1) = {"
k
G
b
P
p
G
G
G
O
O
O
O
O
O
k
Z
"}
(10,1,1) = {"
k
G
p
P
P
N
P
F
O
O
O
a
O
O
k
Z
"}
(11,1,1) = {"
k
G
l
r
p
G
G
G
O
O
O
O
O
O
k
Z
"}
(12,1,1) = {"
k
G
e
r
P
P
s
G
O
U
O
O
O
O
k
Z
"}
(13,1,1) = {"
k
G
J
M
p
p
C
G
O
O
O
L
z
L
k
Z
"}
(14,1,1) = {"
k
G
G
G
G
G
G
G
k
k
k
K
X
K
Z
Z
"}
(15,1,1) = {"
k
k
k
k
k
k
k
k
k
Z
Z
K
X
K
Z
Z
"}
(16,1,1) = {"
Z
Z
Z
Z
Z
Z
Z
Z
Z
Z
Z
S
I
S
Z
Z
"}
