//MAP CONVERTED BY dmm2tgm.py THIS HEADER COMMENT PREVENTS RECONVERSION, DO NOT REMOVE
"a" = (
/turf/open/floor/iron/colony,
/area/ruin/colonist_bunker)
"b" = (
/turf/open/space/basic,
/area/template_noop)
"d" = (
/obj/structure/mineral_door/manual_colony_door,
/turf/open/floor/iron/colony,
/area/ruin/colonist_bunker)
"e" = (
/obj/structure/mineral_door/manual_colony_door,
/turf/open/floor/iron/colony/texture,
/area/ruin/colonist_bunker)
"f" = (
/obj/effect/mob_spawn/ghost_role/human/hermit/icemoon,
/turf/open/floor/iron/colony/bolts,
/area/ruin/colonist_bunker)
"i" = (
/obj/structure/flora/rock/style_random,
/turf/open/misc/basalt,
/area/icemoon/underground/explored)
"j" = (
/obj/structure/cable,
/turf/open/floor/plating/lavaland_baseturf,
/area/ruin/colonist_bunker)
"k" = (
/obj/machinery/portable_atmospherics/canister/oxygen,
/turf/open/floor/iron/colony/bolts,
/area/ruin/colonist_bunker)
"l" = (
/obj/structure/flora/tree/jungle/small/style_random,
/turf/open/floor/grass,
/area/ruin/colonist_bunker)
"n" = (
/obj/structure/rack/wooden,
/obj/item/gun/energy/laser/musket/prime,
/obj/item/pickaxe/drill/compact,
/turf/open/floor/iron/colony,
/area/ruin/colonist_bunker)
"o" = (
/obj/structure/sink/directional/south,
/turf/open/floor/iron/colony,
/area/ruin/colonist_bunker)
"p" = (
/obj/structure/window/fulltile/colony_fabricator,
/obj/machinery/door/poddoor/shutters/colony_fabricator{
	id = "hermit3"
	},
/turf/open/floor/iron/colony,
/area/ruin/colonist_bunker)
"r" = (
/obj/machinery/button/door/directional/west{
	pixel_y = -25;
	id = "hermit2"
	},
/turf/open/floor/iron/colony/texture,
/area/ruin/colonist_bunker)
"s" = (
/turf/open/water/lava_lake,
/area/ruin/colonist_bunker)
"t" = (
/obj/structure/rack/wooden,
/obj/item/storage/bag/ore,
/obj/item/mining_scanner,
/turf/open/floor/iron/colony,
/area/ruin/colonist_bunker)
"u" = (
/obj/machinery/button/door/directional/south{
	id = "hermit1"
	},
/turf/open/floor/iron/colony,
/area/ruin/colonist_bunker)
"v" = (
/obj/structure/chair/plastic{
	dir = 1
	},
/turf/open/floor/grass,
/area/ruin/colonist_bunker)
"w" = (
/turf/open/floor/iron/colony/texture,
/area/ruin/colonist_bunker)
"x" = (
/obj/machinery/hydroponics/soil,
/turf/open/misc/basalt,
/area/icemoon/underground/explored)
"y" = (
/turf/open/misc/basalt,
/area/icemoon/underground/explored)
"z" = (
/obj/machinery/light/warm/directional/east,
/obj/machinery/power/apc/auto_name/directional/east,
/obj/structure/cable,
/obj/structure/rack/wooden,
/obj/item/aquarium_kit,
/obj/item/aquarium_kit,
/obj/item/aquarium_kit,
/obj/item/aquarium_upgrade/bioelec_gen,
/obj/item/aquarium_upgrade/bioelec_gen,
/obj/effect/mapping_helpers/apc/unlocked,
/turf/open/floor/iron/colony,
/area/ruin/colonist_bunker)
"A" = (
/obj/machinery/power/terminal{
	dir = 1
	},
/obj/structure/cable,
/obj/machinery/power/energy_accumulator/tesla_coil,
/turf/open/floor/iron/colony/bolts,
/area/ruin/colonist_bunker)
"B" = (
/obj/machinery/light_switch/directional/south,
/obj/structure/rack/wooden,
/obj/item/knife/combat,
/obj/item/clothing/suit/hooded/explorer,
/obj/item/tank/internals/oxygen/yellow,
/turf/open/floor/iron/colony,
/area/ruin/colonist_bunker)
"C" = (
/obj/structure/rack/wooden,
/obj/item/seeds/plump,
/obj/item/seeds/plump,
/obj/item/seeds/tower,
/obj/item/seeds/reishi,
/obj/item/food/grown/mushroom/glowshroom,
/obj/item/cultivator,
/obj/item/seeds/wheat,
/obj/item/seeds/wheat,
/obj/item/storage/bag/plants/portaseeder,
/obj/item/seeds/corn,
/obj/item/seeds/corn,
/obj/item/seeds/cotton,
/obj/item/seeds/cotton,
/obj/item/seeds/carrot,
/obj/item/seeds/carrot,
/obj/item/seeds/tomato,
/obj/item/seeds/tomato,
/obj/item/seeds/eggplant,
/turf/open/floor/iron/colony,
/area/ruin/colonist_bunker)
"F" = (
/obj/structure/rack/wooden,
/obj/item/stack/sheet/glass/fifty,
/obj/item/stack/sheet/iron/fifty,
/obj/item/stack/sheet/plastic/fifty,
/obj/item/storage/toolbox/fishing,
/obj/item/storage/box/fishing_lines,
/turf/open/floor/iron/colony,
/area/ruin/colonist_bunker)
"G" = (
/obj/structure/table/reinforced/rglass,
/obj/item/reagent_containers/condiment/flour/small_ration,
/obj/item/reagent_containers/condiment/flour/small_ration,
/obj/item/kitchen/rollingpin,
/turf/open/floor/iron/colony,
/area/ruin/colonist_bunker)
"H" = (
/obj/structure/table/reinforced/rglass,
/obj/machinery/reagentgrinder,
/obj/machinery/light/warm/directional/west,
/turf/open/floor/iron/colony,
/area/ruin/colonist_bunker)
"I" = (
/obj/machinery/oven/range_frontier,
/turf/open/floor/iron/colony,
/area/ruin/colonist_bunker)
"J" = (
/obj/machinery/cell_charger_multi/wall_mounted/directional/west,
/turf/open/floor/iron/colony,
/area/ruin/colonist_bunker)
"K" = (
/obj/structure/cable,
/obj/item/flatpacked_machine/arc_furnace,
/obj/machinery/rnd/production/colony_lathe,
/turf/open/floor/iron/colony,
/area/ruin/colonist_bunker)
"L" = (
/obj/structure/cable,
/obj/machinery/button/door/directional/south{
	id = "hermit3"
	},
/turf/open/floor/iron/colony,
/area/ruin/colonist_bunker)
"M" = (
/obj/structure/cable,
/obj/structure/cable,
/turf/closed/wall/prefab_plastic,
/area/ruin/colonist_bunker)
"N" = (
/turf/closed/mineral,
/area/icemoon/underground/explored)
"P" = (
/obj/structure/window/fulltile/colony_fabricator,
/obj/machinery/door/poddoor/shutters/colony_fabricator{
	id = "hermit1"
	},
/turf/open/floor/iron/colony,
/area/ruin/colonist_bunker)
"Q" = (
/obj/structure/window/fulltile/colony_fabricator,
/obj/machinery/door/poddoor/shutters/colony_fabricator{
	id = "hermit2"
	},
/turf/open/floor/iron/colony,
/area/ruin/colonist_bunker)
"R" = (
/turf/closed/wall/prefab_plastic,
/area/ruin/colonist_bunker)
"S" = (
/obj/structure/cable,
/obj/structure/fence/door,
/turf/open/floor/plating/lavaland_baseturf,
/area/ruin/colonist_bunker)
"T" = (
/obj/item/flashlight/lantern,
/turf/open/misc/basalt,
/area/icemoon/underground/explored)
"U" = (
/obj/structure/cable,
/obj/machinery/power/energy_accumulator/grounding_rod,
/turf/open/floor/iron/colony,
/area/ruin/colonist_bunker)
"V" = (
/obj/structure/closet/secure_closet/freezer/fridge/all_access,
/turf/open/floor/iron/colony/bolts,
/area/ruin/colonist_bunker)
"W" = (
/turf/open/floor/grass,
/area/ruin/colonist_bunker)
"X" = (
/turf/open/misc/beach/sand,
/area/ruin/colonist_bunker)
"Y" = (
/obj/machinery/power/smes/battery_pack/precharged,
/obj/structure/cable,
/turf/open/floor/iron/colony,
/area/ruin/colonist_bunker)

(1,1,1) = {"
N
N
N
N
N
N
N
N
N
N
b
b
b
b
b
b
"}
(2,1,1) = {"
N
N
N
N
N
N
N
N
y
y
y
y
y
y
b
b
"}
(3,1,1) = {"
N
R
R
R
R
R
R
R
R
R
x
y
y
y
b
b
"}
(4,1,1) = {"
N
R
V
G
H
J
a
a
k
R
y
y
i
y
b
b
"}
(5,1,1) = {"
N
R
o
a
a
a
a
a
n
P
x
y
y
y
b
b
"}
(6,1,1) = {"
N
R
I
a
a
a
a
a
t
P
y
y
y
y
b
b
"}
(7,1,1) = {"
N
R
l
W
a
a
a
a
u
R
x
y
y
y
b
b
"}
(8,1,1) = {"
N
R
X
X
W
a
a
a
C
R
Q
R
y
y
b
b
"}
(9,1,1) = {"
N
R
s
X
v
a
a
a
w
e
r
d
y
y
b
b
"}
(10,1,1) = {"
N
R
X
X
W
a
a
a
B
R
Q
R
y
i
b
b
"}
(11,1,1) = {"
N
R
l
W
a
a
a
a
L
R
y
y
y
y
b
b
"}
(12,1,1) = {"
N
R
a
a
a
a
a
a
U
p
x
y
y
y
b
b
"}
(13,1,1) = {"
N
R
f
a
F
z
K
Y
A
R
y
T
y
y
b
b
"}
(14,1,1) = {"
N
R
R
R
R
R
R
R
M
R
x
y
i
y
b
b
"}
(15,1,1) = {"
N
N
N
N
N
N
R
j
S
y
y
y
y
y
b
b
"}
(16,1,1) = {"
N
N
N
N
N
N
R
R
R
b
b
b
b
b
b
b
"}
