//MAP CONVERTED BY dmm2tgm.py THIS HEADER COMMENT PREVENTS RECONVERSION, DO NOT REMOVE
"a" = (
/turf/open/misc/beach/sand,
/area/ruin/hermit_fishing)
"b" = (
/obj/structure/flora/bush/reed,
/turf/open/water/hermit,
/area/ruin/hermit_fishing)
"c" = (
/obj/structure/table/wood/fancy/blue,
/obj/item/knife/kitchen,
/turf/open/floor/wood,
/area/ruin/hermit_fishing)
"d" = (
/obj/machinery/hydroponics/soil,
/obj/item/seeds/tower,
/turf/open/misc/grass,
/area/ruin/hermit_fishing)
"e" = (
/obj/item/fishing_hook,
/turf/open/misc/beach/sand,
/area/ruin/hermit_fishing)
"f" = (
/obj/structure/wall_torch/directional/east,
/turf/open/floor/wood,
/area/ruin/hermit_fishing)
"g" = (
/turf/open/misc/grass,
/area/ruin/hermit_fishing)
"h" = (
/obj/item/fishing_line,
/turf/open/misc/beach/sand,
/area/ruin/hermit_fishing)
"i" = (
/obj/structure/wall_torch/directional/east,
/turf/open/misc/beach/sand,
/area/ruin/hermit_fishing)
"j" = (
/obj/structure/wall_torch/directional/south,
/turf/open/misc/beach/sand,
/area/ruin/hermit_fishing)
"k" = (
/obj/item/fishing_lure/lucky_coin,
/obj/item/paper/paperslip/fishing_tip,
/obj/structure/table/wood/fancy/blue,
/turf/open/floor/wood,
/area/ruin/hermit_fishing)
"l" = (
/obj/structure/bonfire/dense/prelit,
/turf/open/misc/beach/sand,
/area/ruin/hermit_fishing)
"m" = (
/obj/effect/turf_decal/sand,
/obj/effect/turf_decal/weather/sand/light{
	dir = 1
	},
/obj/structure/mineral_door/wood,
/turf/open/floor/plating,
/area/ruin/hermit_fishing)
"n" = (
/obj/structure/flora/bush/sparsegrass/style_random,
/turf/open/misc/beach/sand,
/area/ruin/hermit_fishing)
"o" = (
/turf/closed/wall/mineral/sandstone,
/area/ruin/hermit_fishing)
"p" = (
/turf/open/water/hermit/deep,
/area/ruin/hermit_fishing)
"q" = (
/obj/structure/chair/plastic,
/turf/open/misc/beach/sand,
/area/ruin/hermit_fishing)
"r" = (
/turf/open/misc/beach/coast/corner,
/area/ruin/hermit_fishing)
"s" = (
/obj/item/reagent_containers/cup/bucket/wooden,
/turf/open/misc/beach/sand,
/area/ruin/hermit_fishing)
"t" = (
/obj/item/shovel/spade,
/turf/open/misc/asteroid/basalt,
/area/ruin/hermit_fishing)
"u" = (
/turf/open/misc/beach/coast{
	dir = 1
	},
/area/ruin/hermit_fishing)
"v" = (
/turf/open/misc/asteroid/basalt,
/area/ruin/hermit_fishing)
"w" = (
/obj/machinery/hydroponics/soil,
/obj/item/seeds/reishi,
/turf/open/misc/grass,
/area/ruin/hermit_fishing)
"x" = (
/obj/effect/mob_spawn/ghost_role/human/fisher_hermit,
/obj/structure/bed/double/pod{
	dir = 1
	},
/obj/effect/spawner/random/bedsheet/double{
	dir = 1
	},
/turf/open/floor/wood,
/area/ruin/hermit_fishing)
"y" = (
/turf/open/misc/beach/coast{
	dir = 8
	},
/area/ruin/hermit_fishing)
"z" = (
/turf/open/misc/beach/coast{
	dir = 4
	},
/area/ruin/hermit_fishing)
"A" = (
/obj/structure/wall_torch/directional/west,
/obj/structure/flora/bush/sparsegrass/style_random,
/turf/open/misc/beach/sand,
/area/ruin/hermit_fishing)
"B" = (
/obj/structure/flora/bush/large/style_random,
/turf/open/misc/beach/sand,
/area/ruin/hermit_fishing)
"C" = (
/turf/open/floor/wood,
/area/ruin/hermit_fishing)
"D" = (
/obj/effect/turf_decal/sand/plating,
/obj/effect/turf_decal/weather/sand,
/obj/structure/mineral_door/manual_colony_door,
/turf/open/floor/plating,
/area/ruin/hermit_fishing)
"E" = (
/obj/item/fishing_rod/unslotted,
/turf/open/misc/beach/sand,
/area/ruin/hermit_fishing)
"F" = (
/obj/structure/wall_torch/directional/west,
/obj/structure/flora/bush/grassy/style_random,
/turf/open/misc/beach/sand,
/area/ruin/hermit_fishing)
"G" = (
/turf/open/misc/beach/coast,
/area/ruin/hermit_fishing)
"H" = (
/obj/structure/mineral_door/manual_colony_door,
/turf/open/floor/plating,
/area/ruin/hermit_fishing)
"J" = (
/obj/effect/turf_decal/sand,
/obj/machinery/nova/fan/self_powered,
/obj/structure/closet/generic/wall/empty{
	pixel_x = -27
	},
/obj/item/pickaxe/mini,
/obj/item/tank/internals/oxygen,
/obj/item/storage/toolbox/emergency,
/obj/item/clothing/mask/gas,
/turf/open/floor/plating,
/area/ruin/hermit_fishing)
"K" = (
/turf/open/water/hermit,
/area/ruin/hermit_fishing)
"L" = (
/obj/item/storage/bag/plants/portaseeder,
/turf/open/misc/grass,
/area/ruin/hermit_fishing)
"M" = (
/obj/structure/wall_torch/directional/north,
/turf/open/misc/asteroid/basalt,
/area/ruin/hermit_fishing)
"N" = (
/obj/structure/closet/crate/trashcart,
/obj/item/trash/champagne_cork/sabrage,
/obj/item/trash/can/food/beans,
/obj/item/storage/bag/trash/filled,
/obj/item/food/grown/mushroom/glowshroom,
/obj/structure/glowshroom/single,
/turf/open/misc/beach/sand,
/area/ruin/hermit_fishing)
"O" = (
/turf/closed/mineral/random/volcanic,
/area/lavaland/surface/outdoors)
"P" = (
/obj/structure/flora/tree/palm,
/turf/open/misc/beach/sand,
/area/ruin/hermit_fishing)
"Q" = (
/obj/item/cultivator,
/turf/open/misc/asteroid/basalt,
/area/ruin/hermit_fishing)
"R" = (
/turf/open/misc/beach/coast/corner{
	dir = 4
	},
/area/ruin/hermit_fishing)
"S" = (
/turf/closed/wall/mineral/wood,
/area/ruin/hermit_fishing)
"T" = (
/turf/open/misc/beach/coast/corner{
	dir = 8
	},
/area/ruin/hermit_fishing)
"U" = (
/obj/machinery/portable_atmospherics/canister/oxygen,
/turf/open/misc/beach/sand,
/area/ruin/hermit_fishing)
"V" = (
/obj/structure/flora/rock/pile/jungle/style_random,
/turf/open/misc/beach/sand,
/area/ruin/hermit_fishing)
"W" = (
/obj/structure/flora/bush/grassy/style_random,
/turf/open/misc/beach/sand,
/area/ruin/hermit_fishing)
"X" = (
/obj/structure/closet/crate/freezer{
	name = "Cooler"
	},
/obj/item/reagent_containers/cup/glass/bottle/beer/light,
/obj/item/reagent_containers/cup/glass/ice,
/obj/item/storage/cans/sixbeer,
/turf/open/misc/beach/sand,
/area/ruin/hermit_fishing)
"Y" = (
/obj/machinery/hydroponics/soil,
/obj/item/seeds/plump,
/turf/open/misc/grass,
/area/ruin/hermit_fishing)
"Z" = (
/turf/open/misc/beach/coast/corner{
	dir = 1
	},
/area/ruin/hermit_fishing)

(1,1,1) = {"
O
o
o
o
o
o
o
o
o
o
o
o
o
o
O
O
"}
(2,1,1) = {"
O
H
J
D
a
a
a
a
a
E
a
a
A
o
o
O
"}
(3,1,1) = {"
o
o
o
o
a
a
a
a
r
z
z
z
z
T
o
o
"}
(4,1,1) = {"
o
Y
F
a
a
a
a
a
G
b
K
K
K
u
V
o
"}
(5,1,1) = {"
o
w
g
a
a
a
a
X
G
K
p
p
b
u
a
o
"}
(6,1,1) = {"
o
v
g
a
a
n
a
q
G
K
p
p
K
u
a
o
"}
(7,1,1) = {"
o
t
g
a
a
a
a
P
G
K
K
K
K
u
a
o
"}
(8,1,1) = {"
o
v
g
s
a
a
a
a
Z
y
y
y
y
R
a
o
"}
(9,1,1) = {"
o
M
L
a
a
a
a
a
e
a
a
a
a
a
j
o
"}
(10,1,1) = {"
o
Q
g
a
a
a
l
a
a
a
a
a
h
a
a
o
"}
(11,1,1) = {"
o
v
g
a
a
a
a
a
a
a
S
S
S
S
S
o
"}
(12,1,1) = {"
o
Y
g
W
a
a
a
a
a
a
m
C
C
C
x
o
"}
(13,1,1) = {"
o
d
a
a
n
a
a
a
a
a
S
C
C
C
C
o
"}
(14,1,1) = {"
o
o
i
a
a
a
a
a
a
a
S
C
C
f
o
o
"}
(15,1,1) = {"
O
o
o
a
B
a
a
a
U
N
S
k
c
o
o
O
"}
(16,1,1) = {"
O
O
o
o
o
o
o
o
o
o
o
o
o
o
O
O
"}
