//MAP CONVERTED BY dmm2tgm.py THIS HEADER COMMENT PREVENTS RECONVERSION, DO NOT REMOVE
"a" = (
/turf/open/floor/iron/colony,
/area/ruin/powered/hermit)
"b" = (
/turf/open/space/basic,
/area/template_noop)
"d" = (
/obj/structure/mineral_door/manual_colony_door,
/turf/open/floor/iron/colony,
/area/ruin/powered/hermit)
"e" = (
/obj/structure/mineral_door/manual_colony_door,
/turf/open/floor/iron/colony/texture,
/area/ruin/powered/hermit)
"f" = (
/obj/effect/mob_spawn/ghost_role/human/hermit/icemoon,
/turf/open/floor/iron/colony/bolts,
/area/ruin/powered/hermit)
"i" = (
/obj/structure/flora/rock/style_random,
/turf/open/misc/basalt,
/area/icemoon/underground/explored)
"k" = (
/obj/machinery/portable_atmospherics/canister/oxygen,
/turf/open/floor/iron/colony/bolts,
/area/ruin/powered/hermit)
"l" = (
/obj/structure/flora/tree/jungle/small/style_random,
/turf/open/floor/grass,
/area/ruin/powered/hermit)
"n" = (
/obj/structure/rack/wooden,
/obj/item/gun/energy/laser/musket/prime,
/obj/item/pickaxe/drill/compact,
/turf/open/floor/iron/colony,
/area/ruin/powered/hermit)
"o" = (
/obj/structure/sink/directional/south,
/turf/open/floor/iron/colony,
/area/ruin/powered/hermit)
"s" = (
/turf/open/water/beach,
/area/ruin/powered/hermit)
"t" = (
/obj/structure/rack/wooden,
/obj/item/storage/bag/ore,
/obj/item/mining_scanner,
/turf/open/floor/iron/colony,
/area/ruin/powered/hermit)
"v" = (
/obj/structure/chair/plastic{
	dir = 1
	},
/turf/open/floor/grass,
/area/ruin/powered/hermit)
"w" = (
/turf/open/floor/iron/colony/texture,
/area/ruin/powered/hermit)
"x" = (
/obj/machinery/hydroponics/soil,
/turf/open/misc/basalt,
/area/icemoon/underground/explored)
"y" = (
/turf/open/misc/basalt,
/area/icemoon/underground/explored)
"z" = (
/obj/machinery/light/warm/directional/east,
/turf/open/floor/iron/colony,
/area/ruin/powered/hermit)
"A" = (
/obj/machinery/power/terminal{
	dir = 1
	},
/obj/structure/cable,
/turf/open/floor/iron/colony/bolts,
/area/ruin/powered/hermit)
"B" = (
/obj/machinery/light_switch/directional/south,
/obj/structure/rack/wooden,
/turf/open/floor/iron/colony,
/area/ruin/powered/hermit)
"C" = (
/obj/structure/rack/wooden,
/obj/item/seeds/plump,
/obj/item/seeds/plump,
/obj/item/seeds/tower,
/obj/item/seeds/reishi,
/obj/item/food/grown/mushroom/glowshroom,
/obj/item/cultivator,
/turf/open/floor/iron/colony,
/area/ruin/powered/hermit)
"G" = (
/obj/structure/table/reinforced/rglass,
/obj/item/reagent_containers/condiment/flour/small_ration,
/obj/item/reagent_containers/condiment/flour/small_ration,
/obj/item/knife/combat,
/turf/open/floor/iron/colony,
/area/ruin/powered/hermit)
"H" = (
/obj/structure/table/reinforced/rglass,
/obj/machinery/reagentgrinder,
/obj/machinery/light/warm/directional/west,
/turf/open/floor/iron/colony,
/area/ruin/powered/hermit)
"I" = (
/obj/machinery/oven/range_frontier,
/turf/open/floor/iron/colony,
/area/ruin/powered/hermit)
"J" = (
/obj/machinery/cell_charger_multi/wall_mounted/directional/west,
/turf/open/floor/iron/colony,
/area/ruin/powered/hermit)
"K" = (
/obj/machinery/power/apc/auto_name/directional/east,
/obj/machinery/power/terminal{
	dir = 4
	},
/obj/structure/cable,
/turf/open/floor/iron/colony,
/area/ruin/powered/hermit)
"L" = (
/obj/machinery/rnd/production/colony_lathe,
/obj/item/flatpacked_machine/ore_silo,
/obj/item/flatpacked_machine/arc_furnace,
/turf/open/floor/iron/colony,
/area/ruin/powered/hermit)
"M" = (
/obj/structure/cable,
/turf/closed/wall/prefab_plastic,
/area/ruin/powered/hermit)
"N" = (
/turf/closed/mineral,
/area/icemoon/underground/explored)
"Q" = (
/obj/structure/window/fulltile/colony_fabricator,
/obj/machinery/door/poddoor/shutters/colony_fabricator,
/turf/open/floor/iron/colony,
/area/ruin/powered/hermit)
"T" = (
/obj/item/flashlight/lantern,
/turf/open/misc/basalt,
/area/icemoon/underground/explored)
"U" = (
/obj/structure/rack/wooden,
/obj/item/aquarium_upgrade/bioelec_gen,
/obj/item/aquarium_kit,
/obj/item/storage/toolbox/fishing/small,
/turf/open/floor/grass,
/area/ruin/powered/hermit)
"V" = (
/obj/structure/closet/secure_closet/freezer/fridge/all_access,
/turf/open/floor/iron/colony/bolts,
/area/ruin/powered/hermit)
"W" = (
/turf/open/floor/grass,
/area/ruin/powered/hermit)
"X" = (
/turf/open/misc/beach/sand,
/area/ruin/powered/hermit)
"Y" = (
/obj/machinery/power/smes/battery_pack/precharged,
/obj/structure/cable,
/turf/open/floor/iron/colony,
/area/ruin/powered/hermit)
"Z" = (
/turf/closed/wall/prefab_plastic,
/area/ruin/powered/hermit)

(1,1,1) = {"
N
N
N
N
N
N
N
N
N
N
b
b
b
b
b
b
"}
(2,1,1) = {"
N
N
N
N
N
N
N
N
y
y
y
y
y
y
b
b
"}
(3,1,1) = {"
N
Z
Z
Z
Z
Z
Z
Z
Z
Z
x
y
y
y
b
b
"}
(4,1,1) = {"
N
Z
V
G
H
J
a
a
k
Z
y
y
i
y
b
b
"}
(5,1,1) = {"
N
Z
o
a
a
a
a
a
n
Q
x
y
y
y
b
b
"}
(6,1,1) = {"
N
Z
I
a
a
a
a
a
t
Q
y
y
y
y
b
b
"}
(7,1,1) = {"
N
Z
l
W
a
a
a
a
a
Z
x
y
y
y
b
b
"}
(8,1,1) = {"
N
Z
X
X
W
a
a
a
C
Z
Q
Z
y
y
b
b
"}
(9,1,1) = {"
N
Z
s
X
v
a
a
a
w
e
w
d
y
y
b
b
"}
(10,1,1) = {"
N
Z
X
X
W
a
a
a
B
Z
Q
Z
y
i
b
b
"}
(11,1,1) = {"
N
Z
l
U
a
a
a
a
L
Z
y
y
y
y
b
b
"}
(12,1,1) = {"
N
Z
a
a
a
a
a
a
a
Q
x
y
y
y
b
b
"}
(13,1,1) = {"
N
Z
f
a
a
z
K
Y
A
Z
y
T
y
y
b
b
"}
(14,1,1) = {"
N
Z
Z
Z
Z
Z
Z
Z
M
Z
x
y
i
y
b
b
"}
(15,1,1) = {"
N
N
N
N
N
N
N
y
y
y
y
y
y
y
b
b
"}
(16,1,1) = {"
N
N
N
N
N
N
N
N
N
b
b
b
b
b
b
b
"}
